SIZE 10 10 1
START 2 2 0
END 5 4 0
CELLS
0 0 0 RF
1 0 0 LR
2 0 0 LF
4 0 0 RF
5 0 0 LF
6 0 0 RF
7 0 0 LRF
8 0 0 LR
9 0 0 LF
0 1 0 BF
2 1 0 BF
3 1 0 RF
4 1 0 LB
5 1 0 RB
6 1 0 LB
7 1 0 BF
8 1 0 RF
9 1 0 LB
0 2 0 RB
1 2 0 LF
2 2 0 BF
3 2 0 BF
5 2 0 RF
6 2 0 LF
7 2 0 BF
8 2 0 RB
9 2 0 LF
1 3 0 BF
2 3 0 RB
3 3 0 LB
5 3 0 BF
6 3 0 BF
7 3 0 BF
8 3 0 RF
9 3 0 LB
1 4 0 RB
2 4 0 LF
3 4 0 RF
4 4 0 LF
5 4 0 B
6 4 0 BF
7 4 0 BF
8 4 0 RB
9 4 0 LF
1 5 0 RF
2 5 0 LB
3 5 0 BF
4 5 0 RB
5 5 0 LR
6 5 0 LB
7 5 0 BF
9 5 0 BF
1 6 0 BF
3 6 0 RB
4 6 0 LF
7 6 0 RB
8 6 0 LF
9 6 0 BF
1 7 0 RB
2 7 0 LR
3 7 0 LR
4 7 0 LB
8 7 0 RB
9 7 0 LB
